11
10 7
5 0
11111011111
10000010001
10101010101
10101000101
10101111101
10101000001
10101111111
10101000000
10101011111
10100000001
11111111111
