51
50 31
5 50
111111111111111111111111111111111111111111111111111
100010000000000000000010000010001000001000000000001
101110111111111110111110111010101010101011111011101
100010000000000010000010001000100010101010001010001
101011111110111111111011101111111110101110101110101
101000001000100000000010100000100000100000101000101
101110111011101111111010111110101111111111101011101
100010000010100010001010001000100000001000100010001
111011111110111010111011101011111111101010111111111
101000100010001010100000001000001000100010000000001
101110101011101010101111111111101010111110111111101
100000001000101010101000000000100010100010100000101
101111111110101010101011111110111110101011101110101
100010000010101010101010000010100000101000100010001
101110111010101010101010111010101111101110101011101
101000101010101010001000100010001000001010101000101
111011101010101010111111101111111011111010101110111
100010001010001010001000100010001010001000101010001
101110101010111011111010111011101010101011101011101
101000101010100010000010001000001000101010000000101
101110101011101110111111101111101111101011111111101
101000101000001000100000100000101000101000000010001
101011101011111011101110111011101010101111111010111
101000101010001010100010001000101010100010001010001
101010111010101010111011101110101010111010111011101
101010000010101010001010100010001010001010000010001
101111101110101010101010111011111011111010111110111
101000100010100010100000001010000000100010000010001
101010111010111111101111111010111110101111111011101
100010100010001000101000001000001000100010001010001
101110111111101010101011101111111011111010101010111
101000100000100010101010100000100010000010101010100
101010101110111110111010111110101010111110101010101
101010100010000010001010100000001010101000101000101
101011111011111011101010101111111110101011101110101
101000001000001000100010101000100010100010100000101
101111101110111110111110101010101010101110111111101
100010001000100000001000100010101000100000100000001
111110101011101111111010101111101110111110101111111
100000101010100000000010001000001000100010101000001
101111101010111111111111111011111011101011101010101
101000001000100000001000001010000000101000001010101
101111101110111011101010111011111111101111111110111
100000100010100010001010001010000010001000000010001
101110111110101110111111101010111010111111101010101
100010100000100010000010001000100010100000001010101
101110101111101011111010101111101010101111111011101
101000101000001000101010101000001010001000001000001
101011101111111110101010101011111111111010111111101
101000000000000000100000101000000000000010000000001
111110111111111111111111111111111111111111111111111
