51
0 1
0 3
111111111111111111111111111111111111111111111111111
000000100000000000000000001000100000000000000000001
111110101111111110111111101010101011111111111111101
000010101000000010100000001010101000000000000000101
111010111011111010101111111010101111111011111110111
100010000010000010100000000010000010001000001010001
101111111110111110111111111111101110101111101011101
101000100000100010000000001000101000100010000000101
101010101111101011111111101010101011111011111111101
100010100000001000001000101010101010000010000000001
101110111111111111101010111010101011101110111111101
101010000000100000001010100010101000100010100010001
101011101111101111111010101110111110111010111010111
100010101000001000000010001010000000101000100010101
111010101011111011111111111011111111101111101110101
101010101000100010100000100000000000001000000010101
101010101110101110101110101111111011101011111010101
101000100010101000100010101010000010001000101000101
101110101110101110111010101010111011111110101111101
100010100000100010000010000010001010000000000000001
101010111111111010111111111111101010111111111111101
101010100000000010100010000000001010100000000010001
101010101111101110101010111111111110101111111010111
101000100000101010101010000000000000101000100010101
101111111011101010101010111111111111101010101110101
100010000010001010101010001010000000001010101000101
111011111010111010101011101010111111111010101011101
101000001010100000101000101010100000000010101010001
101111101010111111101110101010111010111111101011101
100010001010000000000010100010000010100010001000001
101010111111111111111110111111111110101010111111101
101010000000001000000010000010001000101000100000101
101011111111101011111011101010101011101111101110101
101000000010001010001000101000100000100000001010101
101111101010111010111110111110111111111110111010101
101000001010100010000000100010001000000010001010101
101011111010101110111111101010111011111011101010101
101010001010100010000010001010100010001010101010101
101010101110101011111011101011101110111010101010101
101000100000101000001000001000001000000010000010101
101111111111111111101111111111111011111110111110101
100010000000100000001000000010001000100010100010101
111010111110101111111011111010101110101110101010111
101000100000100000000000001010101000100000101010001
101111101111111110111111111011101011111111101010101
100000101000100010000010001000101000100000101010101
111110101010101011111110101110101110101110101011101
100000101010001010001000100010101000101000101000101
101111101011111010101011111010101011101011101110101
100000000010000000100010000000100000001000001000001
111111111111111111111111111111111111111111111111111
