21
0 17
0 3
111111111111111111111
100000001010000000001
101111101010111111101
001010001000100000001
101010111111101111101
101000001000001000001
101111101011111011111
100000100010001000001
101110111110111111101
100010100000100000001
101110101011101111111
101000101000001010001
101011101111111010101
101010000000001000101
101011111111101111101
101000000000100000101
111110111110111110101
000010100010000010001
111011101011111011101
100000001000000010001
111111111111111111111
