51
0 11
39 0
111111111111111111111111111111111111111011111111111
100000001000000000001000000000100000100010000000001
101011101111101111111010111110111010101010111111101
101000101000101000000010100010100010001010001000001
101110101010101011111110101010101111111111101011101
100010100010100010000010001010001000001000001000101
111010111110111010111011101011111011101011111110101
100010100010001010101000101000001000100010000000101
111110101011101110101110111011101011111110111111101
100010101000000000100010001000101010000000101000001
101010111111111111101111101111101010111111101011111
001010100010001000100000101000100010001000001010001
111010101010101010101011101010111111101010101010111
101010001000101010101010001010000000101010101010001
101011111011101110101010111011111110101010111011101
101010001000100010001010001010001000101010000000001
101010101111111011111011101010111011101011111111101
101010100000100010000000101010000010001000100000101
101010111110101110111011101011101110111110101110111
101010000010001000001010001000101000100010100010001
101011111011111011101010111010101011101011111011101
101000000010000010001010100010101000001000000010001
101111111110111110101110101110101110111111111110101
100010000010100010101000100010100010001000000010101
101010111010101010101011111110111011101111111010101
101010100010101010101000100000101010100000000010101
111010101110111010111110101111101010111111111010101
100010100000000010100000101000001010100000000010101
101010111111111110101111101011101010101111101110111
101010100010000010100000001000100010101000100010001
101110101010111010111111111110111110101010111111101
101000101010101000000000000010001000001010000000001
101011101010101111111110111111101111111011111111101
101010001010100000000010100000100000100010000010001
101010111010111011101110101110111110101110111010111
101010100010001000100000101010000010001000100010001
101010101111101111111111101011101011111010111111101
101010100000101000001000001000101010000010001000001
101010111110101011101011111110101110111111101011111
101010100010100000101010000000101000100000001000001
101010101110111111101011111011101011101111101111101
101000100000101000001000001000101010101000000000101
101111101111101011101111101110101010101111101111101
100000100010001010001000100000101010100000101000001
111010111011101010111011111110101010111110101011111
100010001010001010001010000010101010000010101010001
101111111010111011101010111010101011111010111010101
100010000010001000100010100010101000001010100010101
101010111111101110111110101110101111101010101110101
101000000000000010000000100000100000000010000000101
111111111111111111111111111111111111111111111111111
