21
1 20
3 0
111011111111111111111
100000001000000000001
111110101111111111101
100000100000000000001
101111111111111111101
100010000000001000101
101010111111101011101
101000000010001000001
111110111110111011111
100010100000101010001
101011101111101010101
101010001000100010101
101010111110101110101
101010000010001000101
101011111010111011101
101000000010100010001
101111111110101110101
100010000010101000101
111010101110111011101
100010100000000010001
101111111111111111111
