51
0 13
0 23
111111111111111111111111111111111111111111111111111
101000000000001000100000000010000010000000000010001
101011101111101011101110111110111010111011111011101
100010001000001010000010000000101010100010001000001
111110111011111010111111101111101010101110101111101
100000100010000000101000101000001000101010100010101
101111101111111011101010101011101111101010101010101
100000101000001000001010100010100000101000101010101
101110101011101111111010111110111110101011101010101
100010101000100000000010000010000000101000101000101
101110101110111111111111111011111011101011101110101
101000101000100000100000001000001010101010001000101
111011101011101110101110111111101010101110101111101
000010101000101000100010000010001010101000101000001
111110101110101011111011111010111010101010111011111
100010001000101000001010001000100000101010100010001
111010111011111110101011101111111110101011101110101
100010100010000010101000000000000010101000100010101
101010111010111011101111111111111010101010111011101
101010000010101000100010001000000010101010001000101
101111111110101110101010101011111111101111101110101
101000000000100000001010101010000000100000101000101
101011111011111111111010111010111010101110101011101
001000100010000000101010100010100010100010101000101
101110101110111110101010101111101110101110101110101
100010100000100010101010100000100010101000100000101
111010111111101010101010111110111010111011111110101
100010100000101010101010000010000010001000000010101
101010111110101010101010111011111111101011111010101
101010100000101000100010001000000010101010001010001
101010101110101111101111101111111010101010101011101
101010001000101000100000001000001000101010100010101
101111111011101011111111111011111110101110111110101
100000100010101000000000000010000010100000100000001
101010101110101011111011111110111010111111101111111
101010101000101000100010000010001000100000101000001
101011101110101110101110111011101111111110101010111
101000000000101000100010001000001000000000101010001
101111111111101111111011101111111011111011101011101
101000100000101000001000101000001000100010001000101
101011101110101011101110101110101110101110111111101
101000100010001000100010000000100010100010100000001
101110111011111110111011101111111010111010101111101
101000001000000010101000101000100000100010001000101
101011101111111010101110111010111111101111111110101
100010001000001000100010000010000010000000100000101
111110111011101111111011111111111011111111101011101
101000100010001000000000001000001000001000001000101
101011111110101110111111101110101111101011111110101
100000000000100000100000000000100000100000000010001
111111111111111111111111111111111111111111111111111
