21
17 20
17 0
111111111111111110111
100010000010001000001
101010111110101011101
101000100000100010001
101110101111101110101
101000101000100010101
101111101010111110101
100000101010100000101
101110101010101111101
100010001010001000001
111011111011111111111
100010001000000000001
101111101111111111101
100000100000000000101
111110111111101011101
100000100000001010001
101111101111111010111
101000000010100010001
101111111010101111101
100000000010000010001
111111111111111110111
