21
0 9
5 0
111110111111111111111
100000001000000000001
101111101011111111101
100000101000000010001
101110111111111010101
100010000000100010101
111011111010101110111
100000101010101010001
111110101011101011101
001000101000101010001
101110101110101010101
100010000010000010101
111010111111111010101
101010100000100010101
101011101110101110111
101000001000100010001
101111111011101111101
100010001000101000101
101110101110111010101
100000100000000010001
111111111111111111111
