21
19 20
19 0
111111111111111111101
100000000010001000001
101111101010101110101
100010001000100000101
111110111111111111111
100010000000000000001
101011111011111111101
101000001000100000101
101111101110101111101
101000000010001000001
101111111011111011101
100000100010000010001
101110111010111011111
101010001000100010001
101011101111101110101
101000100000101010101
101011111110101010101
101000000010100010101
101110111010111110101
100000100010000000101
111111111111111111101
